0.2
level_6
level_select
enddoors
endsigns
BBBBBBBBBBBBBBBBBBBBBBBBBBBBBBBBBBBBBBBBBBBBBBBBB
B      B             B                  B       B
B      B             B                  B       B
B      B             B                  B       B
B      B             B                  B       B
B      B             B                  B       B
B      B             B                  B       B
B      B             B                  B       B
B      B                                B       B
B      B                                B    DT B
B      B             B                  B       B
B      B             B      B           B  BBBBBB
B                    B      B           B       B
B                    B      B     B     B       B
BBBB           B            B     B     BBBBB   B
B              B            B     B     B       B
B              B       B    B     B     B       B
B       B  B   B       B    B     B     B       B
B       B  B   B       B    B     B     B   B   B
B       B  B   B       B    B               B   B
B       B  B           B    B               B   B
B                   B  B    B     B     B   B   B
B                   B       B     B     B   B   B
B                   B       B     B     B   B   B
B                   B       B     B     B       B
B    B           B  B  B    B     B  B  B       B
B    B           B  B  B    B     B  B  B       B
B    B           B  B  B    B        B          B
B    B     R     B     B    B        B          B
B    B  D     T  B     B    B        B          B
B    B           B     B    B        B          B
BBBBBBBBBBBBBBBBBBBBBBBBBBBBBBBBBBBBBBBBBBBBBBBBB
