0.2
level_5
level_select
enddoors
freeze_ghosts
endsigns
BBBBBBBBBBBBBBBBBBBBBBBBBBBBBBBBBBBBBBBBBBBBBBBBBBBBBBBBB
B                                                       B
B                                                       B
B                                                       B
B                                                       B
B                                                       B
B                                                       B
B                                                       B
B                                                       B
B                                                    DT B
B                                                       B
BBBBBBBBBBBB      BBBBBBBBBBBBBBBBBBBBBBBBBBBBBBBBBBBBBBB
B                 B                  B                  B
B Y               B         L        B         Z        B
B                 B                  B                  B
BBBBBBBBBBBB      B      BBBBBB      B      BBBBBB      B
B      B          B                  B                  B
B      B                                                B
B      B                                                B
B      BBBBBBBBBBBBBBBBBBBBBBBBBBBBBBBBBBBBB      BBBBBBB
B                                                       B
B                                                       B
B                                                       B
B     R                            BBBBBBBBBBBBBBBBBBBBBB
B  D      T                    BBBBB
B           S              BBBBB
BBBBBBBBBBBBBBBBBBBBBBBBBBBB
